    C P U T X F
    Z S P O T E
    C X Y U P T
    A X U C A C
    M L C H L H
    A S M L E F